cs	#field/cs
cs.AI	#field/ml/ai
cs.AR	#field/cs/hardware
cs.CC	#field/cs/complexity
cs.CG	#field/cs/geometry
cs.CL	#field/ml/nlp
cs.CR	#field/cs/crypto
cs.CV	#field/cs/vision
cs.CY	#field/cs/society
cs.DB	#field/cs/databases
cs.DC	#field/cs/distributedSystems
cs.DL	#field/cs/digitalLibraries
cs.DM	#field/cs/discrete
cs.DS	#field/cs/dataStructures
cs.FL	#field/cs/automata
cs.GR	#field/cs/graphics
cs.GT	#field/cs/gameTheory
cs.HC	#field/cs/hci
cs.IR	#field/cs/ir
cs.IT	#field/cs/information
cs.LG	#field/ml
cs.LO	#field/cs/logic
cs.MA	#field/cs/multiagent
cs.MM	#field/cs/multimedia
cs.MS	#field/cs/mathsoftware
cs.NA	#field/cs/numerical
cs.NE	#field/cs/evolution
cs.NI	#field/cs/internet
cs.OH	#field/cs
cs.OS	#field/cs/operatingSystems
cs.PF	#field/cs/performance
cs.PL	#field/cs/languages
cs.RO	#field/robotics
cs.SC	#field/cs/symbolicComputation
cs.SD	#field/cs/sound
cs.SE	#field/cs/softwareEngineering
cs.SI	#field/cs/socialNetworks
cs.SY	#field/cs/control
econ	#field/economics
econ.EM	#field/economics/econometrics
econ.GN	#field/economics
econ.TH	#field/economics
eess.AS	#field/cs/audioProcessing
eess.IV	#field/cs/imageProcessing
eess.SP	#field/cs/digitalSignalProcessing
eess.SY	#field/cs/control
math.AC	#field/math/algebra/commutative
math.AG	#field/math/algebraicGeometry
math.AP	#field/math/differentialEquations/partial
math.AT	#field/math/algebraicTopology
math.CA	#field/math/differentialEquations/ordinary
math.CO	#field/math/combinatorics
math.CT	#field/math/category
math.CV	#field/math/analysis/complex
math.DG	#field/math/differentialGeometry
math.DS	#field/math/dynamicalSystems
math.FA	#field/math/analysis/functional
math.GM	#field/math
math.GN	#field/math/topology
math.GR	#field/math/group
math.GT	#field/math/topology
math.HO	#field/math/history
math.IT	#field/math/info
math.KT	#field/math/homology
math.LO	#field/math/logic
math.MG	#field/math/geometry/metric
math.MP	#field/math/physics
math.NA	#field/math/numerical
math.NT	#field/math/number
math.OA	#field/math/algebra/operator
math.OC	#field/math/optimization
math.PR	#field/math/prob
math.QA	#field/math/algebra/quantum
math.RA	#field/math/algebra/ring
math.RT	#field/math/representation
math.SG	#field/math/geometry/sympletic
math.SP	#field/math/spectral
math.ST	#field/math/prob
astro-ph	#field/astro
astro-ph.CO	#field/cosmo
astro-ph.EP	#field/astro/planetary
astro-ph.GA	#field/astro/galactic
astro-ph.HE	#field/astro/highEnergy
astro-ph.IM	#field/astro/instruments
astro-ph.SR	#field/astro/stellar
cond-mat	#field/physics/condensed
cond-mat.dis-nn	#field/physics/condensed/neuralnets
cond-mat.mes-hall	#field/physics/condensed/nano
cond-mat.mtrl-sci	#field/physics/condensed/materials
cond-mat.other	#field/physics/condensed
cond-mat.quant-gas	#field/physics/condensed/quantum
cond-mat.soft	#field/physics/condensed
cond-mat.stat-mech	#field/physics/statisticalMechanics
cond-mat.str-el	#field/physics/condensed
cond-mat.supr-con	#field/physics/condensed/superconductors
gr-qc	#field/physics/generalRelativity
hep-ex	#field/physics/highEnergy/experimental
hep-lat	#field/physics/highEnergy/lattice
hep-ph	#field/physics/highEnergy/phenom
hep-th	#field/physics/highEnergy/theory
math-ph	#field/math/physics
nlin	#field/math/nonlinear
nlin.AO	#field/math/nonlinear/selfOrganizing
nlin.CD	#field/math/nonlinear/chaos
nlin.CG	#field/cs/nks/ca
nlin.PS	#field/math/nonlinear/patternFormation
nlin.SI	#field/math/nonLinear/integrable
nucl-ex	#field/physics/nuclear
nucl-th	#field/physics/nuclear
physics	#field/physics
physics.acc-ph	#field/physics
physics.ao-ph	#field/physics/atmospheric
physics.app-ph	#field/physics/applied
physics.atm-clus	#field/physics/atomic
physics.atom-ph	#field/physics/atomic
physics.bio-ph	#field/physics/bio
physics.chem-ph	#field/physics/chemical
physics.class-ph	#field/physics/classicalMechanics#
physics.comp-ph	#field/physics
physics.data-an	#field/physics/data
physics.ed-ph	#field/edu/physics
physics.flu-dyn	#field/physics/fluidMechanics
physics.gen-ph	#field/physics
physics.geo-ph	#field/physics/geo
physics.hist-ph	#field/physics/history
physics.ins-det	#field/physics
physics.med-ph	#field/physics/medical
physics.optics	#field/physics/optical
physics.plasm-ph	#field/physics/plasma
physics.pop-ph	#field/physics/pop
physics.soc-ph	#field/physics/society
physics.space-ph	#field/physics/space
quant-ph	#field/physics/quantum
q-bio	#field/bio
q-bio.BM	#field/bio/molecules
q-bio.CB	#field/bio/cell
q-bio.GN	#field/bio/genetics
q-bio.MN	#field/bio/molecules
q-bio.NC	#field/neuro
q-bio.OT	#field/bio
q-bio.PE	#field/bio/evo
q-bio.QM	#field/bio
q-bio.SC	#field/bio/
q-bio.TO	#field/bio/tissue
q-fin.CP	#field/economics/finance
q-fin.EC	#field/economics
q-fin.GN	#field/economics/finance
q-fin.MF	#field/economics/finance
q-fin.PM	#field/economics/portfolio
q-fin.PR	#field/economics/securities
q-fin.RM	#field/economics/risk
q-fin.ST	#field/economics/statistical
q-fin.TR	#field/economics/markets
stat	#field/statistics
stat.AP	#field/statistics/applied
stat.CO	#field/statistics/algorithms
stat.ME	#field/statistics
stat.ML	#field/ml
stat.OT	#field/statistics
stat.TH	#field/statistics